11111111111111111111
11111111111111111111
11111111111111111111
11111111111111111111
11111111111111111111
11111111111111111111
11111111111111111111
11111111111111111111
11111111111111111111
11111111111111111111
11111111111111111111
11111111111111111111
11111111111111111111
11111111111111111111
11111111111111111111
11111111111111111111
11111111111111111111
11111111111111111111
11111111111111111111
11111111111111111111

22222222222222222222
20000000002200000002
22222222202200222202
20000222202220222202
20220222200000022202
20220000202222222202
20200222200000022202
20222222202222022202
20000000002222022202
22222222202222022202
22000002202000222202
22022202202020222202
22022202202020222202
22022200002020222202
22022202202220000002
22000000202220222222
20000020202220222222
20222200202220222222
20000000200000000002
22222222222220222202

22222222222222222222
20000000002200000002
22222222202200222202
20000222202220222202
20220222200000022202
20220000202222222202
20200222200000022202
20222222202222022202
20000000002222022202
22222222202222022202
22000002202000222202
22022202202020222202
22022202202020222202
22022200002020222202
22022202202220000002
22000000202220222222
20000020202220222222
20222200202220222222
20000000200000000002
22222222222220222202