22222222222222222222
22222222222222222222
22222222222222222222
22222222222222222222
22222222222222222222
22222222222222222222
22222222222222222222
22222222222222222222
22222222222222222222
22222222222222222222
22222222222222222222
22222222222222222222
22222222222222222222
22222222222222222222
22222222222222222222
22222222222222222222
22222222222222222222
22222222222222222222
22222222222222222222
22222222222222222222

00000000000000000000
00000000000000000000
00000000000000000000
00000000000000000000
00000000000000000000
00004444444444400000
00004000003000400000
00004000000000400000
00004000000000400000
00004000000000400000
00004000000000400000
00004000000000000000
00004000000000400000
00004000000000400000
00004000000000400000
00004000000000400000
00004000000000400000
00004444444444400000
00000000000000000000
00000000000000000000

00000000000000000000
00000000000000000000
00000000000000000000
00000000000000000000
00000000000000000000
00004444444444400000
00004000000000400000
00004000000000400000
00004000000000400000
00004000000000400000
00004000000000400000
00004000000000000000
00004000000000400000
00004000000000400000
00004000000000400000
00004000000000400000
00004000000000400000
00004444444444400000
00000000000000000000
00000000000000000000

00000000000000000000
00000000000000000000
00000000000000000000
00000000000000000000
00000000000000000000
00004444444444400000
00004000000000400000
00004000000000400000
00004000000000400000
00004000000000400000
00004000000000400000
00004000000000400000
00004000000000400000
00004000000000400000
00004000000000400000
00004000000000400000
00004000000000400000
00004444444444400000
00000000000000000000
00000000000000000000

00000000000000000000
00000000000000000000
00000000000000000000
00000000000000000000
00000000000000000000
00001111111111100000
00001111111111100000
00001111111111100000
00001111111111100000
00001111111111100000
00001111111111100000
00001111111111100000
00001111111111100000
00001111111111100000
00001111111111100000
00001111111111100000
00001111111111100000
00001111111111100000
00000000000000000000
00000000000000000000